페리	NNG
페이스리프트	NNG
페이스 리프트	NNG
캐스퍼	NNP
캐스퍼 EV	NNP
캐스퍼 ev	NNP
ev	NNP
캐스퍼ev	NNP
캐스퍼EV	NNP
캐스퍼 Ev	NNP
캐스퍼Ev	NNP
카마스터	NNP
카 마스터	NNP
카마	NNP
일렉트릭	NNP
일렉	NNP
캐스퍼 일렉트릭	NNP
electric	NNP
캐스퍼 액티브	NNP
액티브	NNP
엑티브	NNP
블루링크	NNP
인스퍼레이션	NNP
인스퍼	NNP
인스	NNP
스마트	NNP
디 에센셜	NNP
디에센셜	NNP
디에센	NNP
에센셜	NNP
디 에센셜 라이트	NNP
디 에센셜라이트	NNP
디에센셜라이트	NNP
스마트 초이스	NNP
스마트초이스	NNP
블박	NNG
블루핸즈	NNP
블루헨즈	NNP
블루 핸즈	NNP
블루 헨즈	NNP
레이	NNP
모닝	NNP
블루멤버스	NNP
블루맴버스	NNP
블루 맴버스	NNP
블루 멤버스	NNP
네비	NNG
네비게이션	NNG
내비게이션	NNG
내비	NNG
풀옵	NNG
풀옵션	NNG
풀 옵션	NNG
무옵	NNG
무옵션	NNG
무 옵션	NNG
티벡스	NNP
티백스	NNP
TBEX	NNP
tbex	NNP
트림	NNG
스마트스트림	NNP
스마트 스트림	NNP
카파	NNP
스마트 센스	NNP
스마트센스	NNP
컴포트	NNP
컨비니언스	NNP
컨비니언스 플러스	NNP
터보	NNP
논터보	NNP
논 터보	NNP
아틀라스	NNP
아틀라스 화이트	NNP
아틀라스화이트	NNP
톰보이	NNP
톰보이카키	NNP
시에나	NNP
시에나 오렌지	NNP
시에나오렌지	NNP
시에나 오렌지 메탈릭	NNP
시에나오렌지 메탈릭	NNP
시에나오렌지메탈릭	NNP
오렌지 메탈릭	NNP
오렌지메탈릭	NNP
버터크림	NNP
버터크림옐로우	NNP
버터크림 옐로우	NNP
버터크림 옐로우 펄	NNP
버터크림 옐로우펄	NNP
버터크림옐로우펄	NNP
언블리치드	NNP
언블리치드 아이보리	NNP
아이보리	NNP
어비스	NNP
어비스 블랙	NNP
어비스 블랙 펄	NNP
어비스 블랙펄	NNP
블랙펄	NNP
블랙 펄	NNP
에어로 실버	NNP
에어로실버	NNP
에어로 실버 매트	NNP
비자림 카키	NNP
비자림카키	NNP
비자림 카키 매트	NNP
더스크	NNP
더스크 블루 매트	NNP
더스크 블루매트	NNP
더스크블루	NNP
휠베이스	NNG
휠 베이스	NNG
워크쓰루	NNG
워크 쓰루	NNG
폴딩 시트	NNG
풀 폴딩 시트	NNG
폴딩시트	NNG
풀폴딩시트	NNG
애플워치	NNP
카플레이	NNP
카 플레이	NNP
티맵	NNP
네이버	NNP
카카오맵	NNP
카카오	NNP
카카오내비	NNP
카카오 내비	NNP
핸즈프리	NNG
인포테인먼트	NNP
안심케어	NNP
안심 케어	NNP
모빌리티카드	NNP
모빌리티 카드	NNP
에브리케어	NNP
에브리케어 플러스	NNP
에브리 케어	NNP
카페이	NNP
카 페이	NNP
스탑앤고	NNP
풋파킹	NNP
풋 파킹	NNP
스마트크루즈	NNP
스마트 크루즈	NNP
루프랙	NNG
헤드레스트	NNG
헤드 레스트	NNG
크루즈 컨트롤	NNP
크루즈컨트롤	NNP
크루즈콘트롤	NNP
크루즈 콘트롤	NNP
하이패스	NNG
터보 디에센셜	NNP
터보 디 에센셜	NNP
블루 링크	NNP
바디케어	NNP
바디 케어	NNP
멤버스 포인트	NNG
멤버스포인트	NNG
블루멤버스 포인트	NNP
블루 멤버스 포인트	NNP
블루 멤버스포인트	NNP
블루멤버스포인트	NNP
썬팅	NNG
캐스퍼 카드	NNP
캐스퍼카드	NNP
경차카드	NNP
경차 카드	NNP
틴트드글라스	NNG
틴트드 글라스	NNG
틴티드글라스	NNG
틴티드 글라스	NNG
캐스퍼 바디케어 서비스	NNP
캐스퍼바디케어 서비스	NNP
캐스퍼 바디케어서비스	NNP
캐스퍼바디케어서비스	NNP
바디케어 서비스	NNP
바디 케어서비스	NNP
바디 케어 서비스	NNP
바디케어서비스	NNP
현대 캐스퍼 경차카드	NNP
현대 캐스퍼 경차 카드	NNP
현대 캐스퍼경차카드	NNP
현대 캐스퍼경차 카드	NNP
현대캐스퍼 경차카드	NNP
현대캐스퍼 경차 카드	NNP
현대캐스퍼경차카드	NNP
현대캐스퍼경차 카드	NNP
세이브오토	NNP
세이브 오토	NNP
블루세이브 오토	NNP
블루세이브오토	NNP
스센	NNP
엔진스왑	NNG
엔진 스왑	NNG
다운스프링	NNG
다운 스프링	NNG
본넷	NNG
본네트	NNG
룸미러	NNG
룸 미러	NNG
악셀	NNG
영맨	NNG
공임나라	NNP
ㄱㅇㄴㄹ	NNP
캐스퍼 매니아 스티커	NNP
캐스퍼매니아 스티커	NNP
캐스퍼 매니아스티커	NNP
캐스퍼매니아스티커	NNP
캐매스티커	NNP
캐매 스티커	NNP
테일램프	NNG
테일 램프	NNG
브랜드킷	NNG
브랜드 키트	NNG
브랜드키트	NNG
브랜드 KIT	NNG
브랜드 kit	NNG
브랜드KIT	NNG
브랜드kit	NNG
M포인트	NNP
M 포인트	NNP
현대카드 M포인트	NNP
현대카드 M 포인트	NNP
현대 카드 M포인트	NNP
현대카드M포인트	NNP
현대스마트센스	NNP
현대 스마트센스	NNP
현대 스마트 센스	NNP
액티브 플러스	NNG
액티브플러스	NNG
캐스퍼 액티브 플러스	NNG
현대 캐스퍼 액티브 플러스	NNG
퍼마일 보험	NNP
캐롯 퍼마일 보험	NNP
롯데 캐롯 퍼마일 보험	NNP
캐롯 퍼마일 자동차 보험	NNP
롯데 캐롯 퍼마일 자동차 보험	NNP
롯데 캐롯 퍼마일 자동차보험	NNP
롯데캐롯 퍼마일 자동차 보험	NNP
캐롯 퍼마일 자동차보험	NNP
캐롯퍼마일 자동차 보험	NNP
퍼마일 자동차보험	NNP
퍼마일 자동차 보험	NNP
스마트센서	NNP
스마트 센서	NNP
레드멤버스	NNP
레드 멤버스	NNP
기아레드멤버스	NNP
기아 레드멤버스	NNP
기아 레드 멤버스	NNP
m포인트	NNP
현대m포인트	NNP
현대 m포인트	NNP
현대카드 m포인트	NNP
크로스	NNP
틴팅	NNG
익스테리어	NNG
프로젝션 타입	NNG
프로젝션타입	NNG
클리어 타입	NNG
클리어타입	NNG
캐스퍼 전구 전조등 클리어타입	NNP
캐스퍼 전조등 클리어타입	NNP
캐스퍼 클리어타입	NNP
캐스퍼 전구 전조등 클리어 타입	NNP
캐스퍼 전조등 클리어 타입	NNP
캐스퍼 클리어 타입	NNP
캐스퍼 프로젝션 타입	NNP
캐스퍼 프로젝션타입	NNP
캐스퍼 전조등 프로젝션 타입	NNP
캐스퍼 전구 전조등 프로젝션 타입	NNP
캐스퍼 프로젝션 타입  led 전조등	NNP
캐스퍼 프로젝션 타입  led전조등	NNP
캐스퍼 프로젝션타입  led전조등	NNP
캐스퍼 순정led프로젝션타입	NNP
캐스퍼 순정led 프로젝션타입	NNP
캐스퍼 순정led 프로젝션 타입	NNP
디텍오로라	NNP
캐스퍼 디텍오로라	NNP
디텍  오로라	NNP
캐스퍼 디텍 오로라	NNP
디텍 Aurora	NNP
인텐스블루	NNP
인텐스 블루	NNP
판금	NNG
프론트휀더 판금	NNP
프론트 휀더 판금	NNP
프론트 휀다 판금	NNP
프론트휀다 판금	NNP
프론트펜더 판금	NNP
사이드실패널	NNP
사이드 실 패널	NNP
사이드실 패널	NNP
인사이드패널	NNP
인사이드 패널	NNP
원동기	NNG
미세누유	NNG
미세 누유	NNG
미세오일누유	NNG
오일미세누유	NNG
오일 미세 누유	NNG
안드로이드 올인원 마이비	NNP
안드로이드올인원 마이비	NNP
마이비	NNP
안드로이드 올인원 카나로	NNP
안드로이드올인원 카나로	NNP
카나로	NNP
차박등	NNP
식빵등	NNP
카바조	NNP
턴시그널	NNP
턴 시그널	NNP
고뱃지	NNG
고뱃지 홀더	NNG
크롬	NNP
파인뷰	NNP
캐패시터	NNG
에코코리아	NNP
에코 코리아	NNP
캐스퍼 가솔린	NNP
사이드 리피터	NNG
사이드리피터	NNG
레인보우 v90	NNP
레인보우v90	NNP
레이노 s9	NNP
레이노s9	NNP
글라스틴트 산타나	NNP
글라스틴트산타나	NNP
라이노R1	NNP
라이노 R1	NNP
에어홀	NNG
더뉴캐스퍼	NNP
더 뉴 캐스퍼	NNP
더뉴 캐스퍼	NNP
언더코팅	NNG
글러브박스	NNP
글러브 박스	NNP
캐스퍼 애꾸설	NNP
자키	NNG
컬럼기어	NNG
컬럼 기어	NNG
컬럼식 기어	NNG
스탭앤고	NNG
스탑 앤고	NNG
스탑 앤 고	NNG
어라운드뷰	NNG
어라운드 뷰	NNG
휀다	NNP
펜더	NNP
노킹음	NNG
PPF	NNG
에어밴트	NNG
에어 밴트	NNG
에어벤트	NNG
에어 벤트	NNG
오버휀다	NNG
휠하우스	NNG
휠 하우스	NNG
스틸휠	NNG
스틸 휠	NNG
알로이휠	NNG
알로이 휠	NNG
단차	NNG
서스펜션	NNP
멀티링크	NNG
멀티 링크	NNG
멀티 링크 서스펜션	NNG
멀티링크 서스펜션	NNG
멀티 링크식 서스펜션	NNG
멀티링크 식 서스펜션	NNG
토션빔	NNG
토션빔 서스펜션	NNG
토션 빔 식 서스펜션	NNG
레일	NNG
레그룸	NNP
레그 룸	NNP
애프터블로우	NNG
애프터 블로우	NNG
에프터블로우	NNG
에프터 블로우	NNG
TPMS	NNG
자흡	NNG
자연흡기	NNG
자연 흡기	NNG
엉뜨	NNG
핸뜨	NNG
문콕	NNG
차대번호	NNG
차대 번호	NNG
휠보레	NNG
차크닉	NNG
돌빵	NNG
물피도주	NNG
선루프	NNP
선 루프	NNP
썬루프	NNP
썬 루프	NNP
뉴트로 베이지	NNP
뉴트로베이지	NNP
파킹 어시스트	NNP
파킹어시스트	NNP
스토리지	NNG
XRT	NNP
xrt	NNP
엑스알티	NNP
AX	NNP
ax	NNP
뉴 캐스퍼	NNP
뉴캐스퍼	NNP
리어 스포일러	NNP
리어스포일러	NNP
대품	NNG
코드절상	NNG
코드 절상	NNG
투명 돌리	NNP
투명돌리	NNP